R 1080 720
NO textures/dirt.xpm
WE textures/stone.xpm
SO textures/images_1.xpm
EA textures/cup3.xpm
S textures/pillar.xpm

F 61, 107, 84
C 86, 150, 0



















11111111111111111111 111111111111
1000020000222200000110000000000001
101100020022220W0001110000000000001
1001000000002000000000000020000001                  1
1111111110110000011100000000000011                 101
100000000011000001110111110111111                   1
1111011111 111011100000010001
111101111 1 11011101010010001
11000000110101011100000010001
10000200000000001100000010001
10000000000000001101010000011
1100000111010101111101111011
11110111 1110101 101111010001
111111111111111   1111111111
1000000001
 1111111101
        11
